<?xml version="1.0"?>
<map>
	<tile_layout>
		0 0 0 0 0 0 0 0 0 0 0 0 0 0 0
		0 0 0 0 0 0 0 1 0 0 0 0 0 0 0
		0 0 0 0 0 0 1 1 1 0 0 0 0 0 0
		0 0 0 0 0 0 0 0 0 0 0 0 0 0 0
		0 0 1 1 1 1 1 1 1 1 1 1 1 0 0
		0 1 1 1 1 1 1 1 1 1 1 1 1 1 0
		0 0 0 0 0 0 0 0 0 0 0 0 0 0 0
		0 1 1 1 1 1 1 1 1 1 1 1 1 1 0
		0 0 1 1 1 1 1 1 1 1 1 1 1 0 0
		0 0 0 1 1 2 1 1 1 2 1 1 0 0 0
		0 0 0 0 1 1 1 1 1 1 1 0 0 0 0
		0 0 0 0 0 1 1 1 1 1 0 0 0 0 0
		0 0 0 0 0 0 1 1 1 0 0 0 0 0 0
		0 0 0 0 0 0 0 1 0 0 0 0 0 0 0
		0 0 0 0 0 0 0 0 0 0 0 0 0 0 0
	</tile_layout>
	<collision_layout>
		1 1 1 1 1 1 1 1 1 1 1 1 1 1 1
		1 1 1 1 1 1 1 0 1 1 1 1 1 1 1
		1 1 1 1 1 1 0 0 0 1 1 1 1 1 1
		1 1 1 1 1 1 1 1 1 1 1 1 1 1 1
		1 1 0 0 0 0 0 0 0 0 0 0 0 1 1
		1 0 0 0 0 0 0 0 0 0 0 0 0 0 1
		1 1 1 1 1 1 1 1 1 1 1 1 1 1 1
		1 0 0 0 0 0 0 0 0 0 0 0 0 0 1
		1 1 0 0 0 0 0 0 0 0 0 0 0 1 1
		1 1 1 0 0 1 0 0 0 1 0 0 1 1 1
		1 1 1 1 0 0 0 0 0 0 0 1 1 1 1
		1 1 1 1 1 0 0 0 0 0 1 1 1 1 1
		1 1 1 1 1 1 0 0 0 1 1 1 1 1 1
		1 1 1 1 1 1 1 0 1 1 1 1 1 1 1
		1 1 1 1 1 1 1 1 1 1 1 1 1 1 1
	</collision_layout>
</map>